0 1 0 0 0 1 2 0 1 32 1 0 2 1 0 1 0 2 0 0
1 1 0 0 2 0 1 1 1 2 1 1 1 0 1 0 1 1 0 0
0 0 0 1 0 0 2 0 1 0 1 0 2 1 0 1 0 2 0 0
0 0 2 0 0 1 1 2 0 2 0 2 1 0 1 0 1 1 0 0
0 1 0 0 1 1 2 0 1 0 1 0 2 1 0 1 0 2 0 0
2 0 0 1 1 1 1 1 1 1 1 1 1 1 1 1 1 1 0 0
0 0 1 1 0 1 0 0 0 0 0 0 0 1 0 0 0 0 0 0
0 1 1 0 0 1 0 0 0 1 0 0 0 1 0 2 0 0 0 0
1 1 0 2 0 1 0 0 1 1 1 0 0 1 0 0 0 0 0 0
0 0 0 0 0 1 0 1 1 2 1 1 0 1 0 2 0 0 0 0
0 0 0 2 0 1 0 1 1 2 1 1 0 1 0 0 0 0 0 0
0 0 0 0 0 1 0 0 1 1 1 0 0 1 0 2 0 0 1 1
0 0 0 2 0 1 0 0 0 1 0 0 0 1 0 0 0 1 1 0
0 0 0 0 0 1 0 0 0 0 0 0 0 1 0 0 1 1 0 0
0 0 1 1 1 1 1 1 1 1 1 1 1 1 0 1 1 0 0 2
0 0 2 0 1 0 1 2 0 1 0 1 0 2 1 1 0 0 1 0
0 0 1 1 0 1 0 1 2 0 2 0 2 1 1 0 0 2 0 0
0 0 2 0 1 0 1 2 0 1 0 1 0 2 0 0 1 0 0 0
0 0 1 1 0 1 0 1 1 1 2 1 1 1 0 2 0 0 1 1
0 0 2 0 1 0 1 2 0 1 31 1 0 2 1 0 0 0 1 0
